#########################################
# #   #   #   #       #               # #
# ### # # # # # # # ### # # ### ### # # #
#       # # #   # # #   # #   #   # #   #
# # ### # # ### ######### # # ####### # #
# #   #   #   # #         # # # #     # #
####### ####### ##### ######### # ##### #
# # #   # #   # #     #   #     # #     #
# # # # # # ### # ### ### ##### # ### # #
#   # #   #   # #   # #       #     # # #
# # ##### # ### # ### # ### ### ### # # #
# # #   #           # # #   #     # # # #
### ### # ######### # # #################
#   #   # #   # # # #   #     # #   #   #
# ### ####### # # ### # ### ### ### # ###
# #           #   # # #       # #   #   #
# # ##### ##### ### # ### ### # # ### # #
#     #   # # #   # # #     #       # # #
### ##### # # # ### ### ### ####### # ###
#   #               #   # #   #   #     #
# ### # ##### ####### # # # ### # ### ###
#   # # #       # #   #   #   # # #     #
# ### ### ##### # # # ### ### # # ### # #
#   # #     # # # # # #     # # # #   # #
# ########### # # # ####### ### ####### #
#   # #     #           #   # #   #     #
# ### # ### # ####### # # ### # # ##### #
# #       #     #     # # #     # #   # #
# ######### ##### ### ### ### ####### # #
#   #   #   #   # #   #   #   # #     # #
# # # # # ### # ##### ##### # # # # ### #
# # # #       #     #       # # # # #   #
### ####### # # # ### ### # # # # # # # #
# # #   #   # # # # # # # # #     # # # #
# # ### ##### # # # ### ####### ####### #
#     #   # # # # #   # #           #   #
### ### # # # ### # # # # # ##### ### ###
#   #   # #   #     # # # #     #   # # #
##### ### ##### ### ### # # ### # # ### #
#       #         # #     # #   # #      
#########################################
